//MAP CONVERTED BY dmm2tgm.py THIS HEADER COMMENT PREVENTS RECONVERSION, DO NOT REMOVE
"a" = (
/turf/environment/space,
/area/space)
"g" = (
/turf/simulated/wall/r_wall,
/area/shuttle/controllable/daedalus)
"s" = (
/obj/machinery/door/airlock/hatch,
/turf/simulated/floor,
/area/shuttle/controllable/daedalus)
"t" = (
/turf/simulated/floor,
/area/shuttle/controllable/daedalus)
"A" = (
/obj/docking_port/mobile/daedalus{
	dir = 2
	},
/turf/simulated/floor,
/area/shuttle/controllable/daedalus)
"B" = (
/obj/machinery/computer/ship/engines,
/obj/structure/window/reinforced{
	dir = 1
	},
/obj/structure/window/reinforced{
	dir = 4
	},
/turf/simulated/floor,
/area/shuttle/controllable/daedalus)
"G" = (
/obj/machinery/power/apc/largecell{
	dir = 4;
	pixel_x = 32
	},
/obj/machinery/light/spot{
	dir = 4
	},
/turf/simulated/floor,
/area/shuttle/controllable/daedalus)
"O" = (
/obj/machinery/computer/ship/sensors,
/obj/structure/window/reinforced{
	dir = 1
	},
/obj/structure/window/reinforced{
	dir = 8
	},
/turf/simulated/floor,
/area/shuttle/controllable/daedalus)
"S" = (
/obj/machinery/light/spot{
	dir = 8
	},
/turf/simulated/floor,
/area/shuttle/controllable/daedalus)
"U" = (
/obj/machinery/computer/ship/helm,
/obj/structure/window/reinforced{
	dir = 1
	},
/turf/simulated/floor,
/area/shuttle/controllable/daedalus)
"W" = (
/obj/machinery/light/spot{
	dir = 4
	},
/turf/simulated/floor,
/area/shuttle/controllable/daedalus)

(1,1,1) = {"
a
a
a
a
a
a
a
a
a
"}
(2,1,1) = {"
a
a
a
g
g
s
g
g
a
"}
(3,1,1) = {"
a
a
O
S
t
t
S
g
a
"}
(4,1,1) = {"
a
a
U
t
A
t
t
s
a
"}
(5,1,1) = {"
a
a
B
G
t
t
W
g
a
"}
(6,1,1) = {"
a
a
a
g
g
s
g
g
a
"}
(7,1,1) = {"
a
a
a
a
a
a
a
a
a
"}
