//MAP CONVERTED BY dmm2tgm.py THIS HEADER COMMENT PREVENTS RECONVERSION, DO NOT REMOVE
"a" = (
/turf/environment/space,
/area/space)
"b" = (
/obj/structure/window/reinforced{
	dir = 1
	},
/obj/machinery/computer/ship/helm,
/turf/simulated/floor/plating,
/area/shuttle/controlable)
"e" = (
/obj/structure/falsewall/reinforced,
/turf/simulated/floor/plating,
/area/shuttle/controlable)
"g" = (
/obj/structure/window/reinforced{
	dir = 1
	},
/obj/structure/window/reinforced{
	dir = 8
	},
/obj/machinery/computer/ship/sensors,
/turf/simulated/floor/plating,
/area/shuttle/controlable)
"m" = (
/turf/simulated/floor/plating,
/area/shuttle/controlable)
"A" = (
/obj/machinery/door/airlock/hatch,
/turf/simulated/floor/plating,
/area/shuttle/controlable)
"H" = (
/obj/structure/window/reinforced{
	dir = 1
	},
/obj/structure/window/reinforced{
	dir = 4
	},
/obj/machinery/computer/ship/engines,
/turf/simulated/floor/plating,
/area/shuttle/controlable)
"L" = (
/obj/structure/stool/bed/chair/schair/wagon{
	dir = 1
	},
/turf/simulated/floor/plating,
/area/shuttle/controlable)
"R" = (
/obj/machinery/power/apc/largecell,
/turf/simulated/floor/plating,
/area/shuttle/controlable)

(1,1,1) = {"
a
a
a
a
a
a
a
a
a
"}
(2,1,1) = {"
a
a
e
e
A
e
a
a
a
"}
(3,1,1) = {"
a
g
m
m
m
m
e
a
a
"}
(4,1,1) = {"
a
b
L
m
m
A
m
A
a
"}
(5,1,1) = {"
a
H
m
R
m
m
e
a
a
"}
(6,1,1) = {"
a
a
e
e
A
e
a
a
a
"}
(7,1,1) = {"
a
a
a
a
a
a
a
a
a
"}

(1,1,2) = {"
a
a
a
a
a
a
a
a
a
"}
(2,1,2) = {"
a
a
a
a
a
a
a
a
a
"}
(3,1,2) = {"
a
a
a
a
a
a
a
a
a
"}
(4,1,2) = {"
a
a
a
a
a
a
a
a
a
"}
(5,1,2) = {"
a
a
a
a
a
a
a
a
a
"}
(6,1,2) = {"
a
a
a
a
a
a
a
a
a
"}
(7,1,2) = {"
a
a
a
a
a
a
a
a
a
"}

(1,1,3) = {"
a
a
a
a
a
a
a
a
a
"}
(2,1,3) = {"
a
a
a
a
a
a
a
a
a
"}
(3,1,3) = {"
a
a
a
a
a
a
a
a
a
"}
(4,1,3) = {"
a
a
a
a
a
a
a
a
a
"}
(5,1,3) = {"
a
a
a
a
a
a
a
a
a
"}
(6,1,3) = {"
a
a
a
a
a
a
a
a
a
"}
(7,1,3) = {"
a
a
a
a
a
a
a
a
a
"}

(1,1,4) = {"
a
a
a
a
a
a
a
a
a
"}
(2,1,4) = {"
a
a
a
a
a
a
a
a
a
"}
(3,1,4) = {"
a
a
a
a
a
a
a
a
a
"}
(4,1,4) = {"
a
a
a
a
a
a
a
a
a
"}
(5,1,4) = {"
a
a
a
a
a
a
a
a
a
"}
(6,1,4) = {"
a
a
a
a
a
a
a
a
a
"}
(7,1,4) = {"
a
a
a
a
a
a
a
a
a
"}

(1,1,5) = {"
a
a
a
a
a
a
a
a
a
"}
(2,1,5) = {"
a
a
a
a
a
a
a
a
a
"}
(3,1,5) = {"
a
a
a
a
a
a
a
a
a
"}
(4,1,5) = {"
a
a
a
a
a
a
a
a
a
"}
(5,1,5) = {"
a
a
a
a
a
a
a
a
a
"}
(6,1,5) = {"
a
a
a
a
a
a
a
a
a
"}
(7,1,5) = {"
a
a
a
a
a
a
a
a
a
"}

(1,1,6) = {"
a
a
a
a
a
a
a
a
a
"}
(2,1,6) = {"
a
a
a
a
a
a
a
a
a
"}
(3,1,6) = {"
a
a
a
a
a
a
a
a
a
"}
(4,1,6) = {"
a
a
a
a
a
a
a
a
a
"}
(5,1,6) = {"
a
a
a
a
a
a
a
a
a
"}
(6,1,6) = {"
a
a
a
a
a
a
a
a
a
"}
(7,1,6) = {"
a
a
a
a
a
a
a
a
a
"}

(1,1,7) = {"
a
a
a
a
a
a
a
a
a
"}
(2,1,7) = {"
a
a
a
a
a
a
a
a
a
"}
(3,1,7) = {"
a
a
a
a
a
a
a
a
a
"}
(4,1,7) = {"
a
a
a
a
a
a
a
a
a
"}
(5,1,7) = {"
a
a
a
a
a
a
a
a
a
"}
(6,1,7) = {"
a
a
a
a
a
a
a
a
a
"}
(7,1,7) = {"
a
a
a
a
a
a
a
a
a
"}

(1,1,8) = {"
a
a
a
a
a
a
a
a
a
"}
(2,1,8) = {"
a
a
a
a
a
a
a
a
a
"}
(3,1,8) = {"
a
a
a
a
a
a
a
a
a
"}
(4,1,8) = {"
a
a
a
a
a
a
a
a
a
"}
(5,1,8) = {"
a
a
a
a
a
a
a
a
a
"}
(6,1,8) = {"
a
a
a
a
a
a
a
a
a
"}
(7,1,8) = {"
a
a
a
a
a
a
a
a
a
"}
